.................................
.1...............................
.................................
.................................
..............#####..............
......##......#.S.#......##......
......#H......#...#......H#......
.....##.....###...###.....##.....
.....#............,........#.....
........###...........###........
........#.....#####.....#........
........#H....#...#....H#........
........#.....#####.....#........
........###...........###........
.....#.....................#.....
.....##.....###...###.....##.....
......#H......#...#......H#......
......##......#.S.#......##......
..............#####..............
.................................
.................................
...............................2.
.................................
