1...............................
................................
....#H.....................#....
....##....................##....
................................
...........###....###...........
...........#S......H#...........
...........#........#...........
................................
......###..............###......
......#.......####......H#......
......#.......#..#.......#......
......#.......#..#.......#......
......#H......####.......#......
......###..............###......
................................
...........#........#...........
...........#H......S#...........
...........###....###...........
................................
....##....................##....
....#.....................H#....
................................
...............................2