1...............................
....#......................#....
....#H.....................#....
....####................####....
................................
...........####..####...........
...........#S.......#...........
...........#........#...........
................................
......###..............###......
......#.......####......H#......
......#.......#..#.......#......
......#.......#..#.......#......
......#H......####.......#......
......###..............###......
................................
...........#........#...........
...........#.......S#...........
...........####..####...........
................................
....####................####....
....#.....................H#....
....#......................#....
...............................2